バトルフィールド
.................................
.................................
.................................
.................................
.................................
.................................
.................................
.................................
.................................
......000000000000000000000......
.................................
.................................
.................................
.................................
.................................
.................................

.................................
.................................
.................................
.................................
.................................
.................................
.................................
.................................
.................................
.....00000000000000000000000.....
......000000000000000000000......
.................................
.................................
.................................
.................................
.................................

.................................
.................................
..........PPPPPPPPPPPPP..........
..........PPPPPPPPPPPPP..........
.................................
...............555...............
.........555.........555.........
.................................
.........p.p.p.p.p.p.p.p.........
.....00000000000000000000000.....
.....00000000000000000000000.....
......000000000000000000000......
.................................
.................................
.................................
.................................

.................................
.................................
.................................
.................................
.................................
.................................
.................................
.................................
.................................
.....00000000000000000000000.....
......000000000000000000000......
.................................
.................................
.................................
.................................
.................................

.................................
.................................
.................................
.................................
.................................
.................................
.................................
.................................
.................................
......000000000000000000000......
.................................
.................................
.................................
.................................
.................................
.................................